Name;Volume;Ask Size;Ask Price;Bid Size;Bid Price;Last Price;Shares Matched;Shares Routed
UVIX;3588463;23036;350;16200;349;349;3364302;224161
MSTU;2688689;200;953;1100;952;952;2663245;25444
MSTZ;1868011;305;1858;200;1856;1857;1837393;30618
TSLZ;1697617;31000;250;114772;249;250;1691961;5656
NVDQ;1385213;56754;298;65751;297;298;1379181;6032
UVXY;1183010;150;2127;100;2125;2124;1160759;22251
NVDX;1064752;5900;1516;13700;1515;1512;1021960;42792
ETHU;601234;7500;747;1747;746;746;600879;355
VXX;452984;20;4667;110;4664;4664;443278;9706
FBTC;424237;320;8272;130;8268;8271;422540;1697
BITX;418065;50;5265;101;5262;5264;416001;2064
IGV;389421;25;9898;325;9897;9898;388768;653
IWMI;332730;500;4905;500;4897;4900;332730;0
IEFA;262626;8200;7083;700;7082;7083;261495;1131
ARKG;262365;400;2553;730;2551;2553;261657;708
ITB;247262;50;10249;150;10246;10250;245386;1876
INDA;232353;5403;5232;3500;5231;5231;231633;720
SVIX;208063;100;2473;100;2462;2475;207863;200
USHY;206320;30901;3691;13900;3690;3690;206318;2
ARKB;133328;100;9450;100;9446;9451;131658;1670
FLOT;131643;11651;5094;14294;5093;5094;131643;0
GOVT;127453;191849;2237;247200;2236;2236;122504;4949
CALF;109105;1396;4405;1600;4403;4405;107713;1392
TSLT;96099;210;3579;60;3575;3585;92196;3903
QDTE;90498;700;3991;8;3990;3990;90343;155
MOAT;87922;630;9246;610;9244;9243;87403;519
VIXY;87536;100;4594;25;4586;4584;85725;1811
PAVE;76756;600;4045;400;4044;4045;74822;1934
COWZ;66391;200;5675;410;5674;5675;66390;1
EZU;62807;600;4784;500;4783;4783;62600;207
EFV;60718;1800;5277;400;5276;5275;60218;500
USMV;53940;855;8880;151;8879;8880;51211;2729
SVXY;50547;100;4949;200;4945;4950;50417;130
NOBL;50187;100;9872;10;9871;9870;47011;3176
ITA;49762;100;14584;300;14578;14581;49562;200
SPYI;49145;1500;5108;3;5107;5106;49132;13
ICVT;47384;601;8546;606;8541;8543;47384;0
XDTE;44702;2000;4993;2000;4983;4989;44682;20
REM;43092;670;2134;270;2133;2133;41621;1471
IDV;41424;411;2731;600;2730;2731;40264;1160
FETH;40975;300;3313;700;3310;3310;40624;351
QDEC;38565;4100;2771;200;2761;2765;38314;251
BBJP;37981;3331;5484;1500;5483;5483;37981;0
FBCG;37290;200;4719;4;4714;4715;36888;402
AAAU;36761;35690;2640;26900;2639;2639;36761;0
HYD;36551;400;5168;288;5167;5168;36551;0
GOVZ;35606;16700;954;6700;953;953;35606;0
TLTW;34477;900;2316;3904;2315;2316;34475;2
MTUM;32462;100;20934;700;20928;20936;32435;27
JCPB;31718;3201;4585;2400;4584;4584;31712;6
BUFR;31305;3900;3056;1900;3055;3055;31305;0
RDVI;30069;700;2454;100;2451;2453;30069;0
QUAL;27222;100;17910;210;17907;17908;23896;3326
EFG;25900;110;9807;329;9799;9803;25900;0
ECH;24395;615;2530;200;2528;2527;24395;0
HEFA;22816;1200;3523;141;3522;3522;22816;0
NEAR;20966;1613;5050;9327;5049;5050;20295;671
DFIC;20805;1300;2594;1700;2593;2592;20505;300
ICSH;20604;13141;5050;10371;5049;5050;20604;0
JBBB;19957;17401;4921;5549;4920;4920;19329;628
ARKQ;19811;140;7973;520;7967;7965;19811;0
LVHI;19686;500;3070;100;3065;3070;19686;0
BBEU;19648;1110;5608;3;5607;5608;19648;0
CBOE;19188;100;19083;110;19055;19077;19188;0
BTCZ;19164;10309;565;10409;564;567;19164;0
ACWV;18533;1225;10869;1000;10865;10867;18533;0
VLUE;18230;100;10613;1200;10611;10613;18124;106
PLTR;17902;64;4984;199;4980;4986;17902;0
IFRA;17880;154;4579;100;4577;4578;13919;3961
HYDB;17832;2836;4709;659;4708;4708;17330;502
BALT;17484;700;3149;211;3148;3148;17484;0
BBCA;16702;100;7135;1000;7131;7132;15602;1100
ITM;16566;238;4597;600;4596;4596;16295;271
IAGG;16404;2800;4974;2200;4973;4974;16404;0
WTAI;15979;300;2243;600;2241;2242;15004;975
JMST;15605;7414;5074;13229;5073;5074;15605;0
CETH;15553;1700;1657;1700;1655;1657;15553;0
JMUB;15419;400;5007;1200;5006;5006;15419;0
BOXX;15319;2313;11041;1406;11040;11041;15319;0
IYT;15301;400;6887;320;6882;6882;15194;107
VUSB;15046;3380;4966;14643;4965;4966;15046;0
SMIN;14952;200;7508;300;7501;7505;14652;300
CNYA;14773;1000;2694;602;2692;2688;14773;0
IGEB;14588;1100;4413;1191;4412;4411;14588;0
SATO;14562;1000;1974;1000;1971;1975;14562;0
GSEW;14533;400;7765;299;7757;7761;14533;0
OMFL;14371;400;5456;100;5455;5456;14171;200
GCOW;14042;100;3380;100;3378;3378;14042;0
EZBC;13954;400;5489;600;5485;5484;12849;1105
ESGV;13872;110;10550;700;10547;10549;13607;265
BTCO;13655;400;9459;300;9447;9439;13655;0
PJAN;13138;400;4237;500;4231;4234;13138;0
PSFF;13060;3600;2939;88;2931;2938;13060;0
YBTC;12969;500;4892;1;4880;4879;12954;15
DFIS;12302;100;2440;300;2437;2439;11602;700
VNM;12266;300;1138;251;1137;1137;12265;1
ARKX;11926;103;2011;100;2009;2008;11926;0
EZET;11674;900;2519;901;2515;2529;11674;0
BBHY;11481;1600;4622;400;4621;4621;11481;0
XSHD;11440;1100;1435;600;1433;1434;11440;0
SYLD;11172;300;6810;300;6799;6805;11172;0
ISPY;11147;337;4446;200;4441;4444;11147;0
EEMV;10937;46;5784;28;5782;5781;8749;2188
IBMN;10844;1300;2665;600;2664;2664;10844;0
BBEM;10387;500;5114;1100;5103;5113;10341;46
BBAX;10384;2300;4924;800;4921;4922;10384;0
PTLC;10282;1600;5377;200;5374;5374;10282;0
ICOW;9863;100;2940;400;2938;2939;8335;1528
IYZ;9748;1700;2676;5100;2674;2675;9748;0
EFAV;9604;100;7078;200;7075;7075;9580;24
HODL;9604;100;10715;400;10705;10716;9544;60
TMFC;9589;800;6037;1600;6032;6033;9589;0
PICK;9505;100;3513;229;3511;3512;9404;101
HYMU;9396;900;2266;240;2265;2266;9396;0
FLBL;9352;1100;2434;1627;2433;2434;8694;658
ICF;9235;200;5925;800;5923;5925;9235;0
IBHE;8815;1733;2321;800;2320;2320;8815;0
ZALT;8676;900;2991;300;2986;2990;8676;0
IGRO;8533;200;6820;100;6809;6819;8533;0
IBHG;8423;392;2229;600;2228;2229;8423;0
OVM;8353;100;2172;100;2160;2171;8353;0
VIXM;8347;400;1474;800;1468;1469;8347;0
BTCL;8037;200;4969;533;4958;4950;8037;0
GSEE;8012;100;4347;500;4343;4345;8012;0
HYBL;7919;700;2845;500;2844;2844;7919;0
FLIA;7878;600;2017;700;2016;2017;7878;0
DRSK;7791;4600;2744;500;2741;2745;7791;0
IBMP;7693;3700;2518;100;2515;2517;7693;0
FRDM;7683;100;3359;100;3344;3346;7683;0
DDEC;7355;4179;4026;700;4019;4018;7355;0
DIHP;7191;2500;2550;55;2549;2548;7191;0
PBUS;7068;100;5925;100;5923;5924;7068;0
PDEC;6949;400;3855;400;3849;3845;6949;0
MLN;6910;1200;1770;3202;1769;1770;6910;0
USMF;6607;2500;4966;1500;4954;4937;6607;0
RDTE;6252;1;4065;1;4061;4062;6252;0
DMAX;6157;1000;2507;1242;2502;2506;6057;100
NANC;5817;2700;3905;2700;3898;3902;5817;0
ZECP;5803;1600;3061;1638;3057;3059;5803;0
IBMO;5801;1600;2549;1400;2548;2545;5801;0
BBIN;5736;100;5748;900;5745;5746;5436;300
DISV;5628;200;2654;530;2650;2651;5628;0
CEMB;5609;800;4443;600;4442;4442;5609;0
BALI;5498;500;3045;100;3042;3031;5498;0
ETHV;5243;700;4853;500;4848;4854;5243;0
TOLL;5208;200;3184;200;3172;3173;5208;0
SDVD;5169;100;2154;100;2151;2149;5169;0
NUSC;4894;300;4210;100;4208;4207;4894;0
PTMC;4678;400;3708;100;3705;3697;4678;0
HYHG;4658;100;6583;200;6563;6574;4658;0
NUMV;4462;1100;3480;700;3478;3478;4462;0
IBHI;4334;596;2353;1777;2349;2352;4334;0
VSGX;4333;200;5681;1;5671;5676;4278;55
BBUS;4295;800;10663;100;10661;10662;4295;0
EYLD;4254;3200;3158;900;3140;3141;4254;0
BTCW;4247;300;10072;300;10047;10040;4247;0
IQDG;4211;100;3480;1100;3478;3477;4011;200
VFMO;4205;600;16544;100;16533;16534;4205;0
FLQM;4201;100;5456;200;5450;5452;4201;0
FBCV;4158;200;3162;100;3158;3162;4158;0
FFLC;4142;200;4651;601;4645;4645;4141;1
MSMR;4060;100;3033;100;3026;3036;4060;0
REGL;4010;700;7958;500;7951;7942;4010;0
GROZ;3969;1000;2505;1300;2500;2504;3969;0
ETU;3949;200;3731;200;3723;3720;3949;0
NULG;3881;100;8693;200;8684;8678;3881;0
IGE;3815;500;4393;100;4391;4385;3815;0
EMGF;3801;400;4528;600;4519;4520;3801;0
FLDR;3752;550;4993;372;4992;4992;3752;0
HYIN;3720;500;1793;1;1792;1792;3720;0
BUFD;3654;200;2559;700;2552;2553;3654;0
VFMV;3650;500;12077;100;12073;12057;3650;0
EMHY;3534;706;3822;500;3821;3822;3534;0
FDEC;3533;400;4477;15;4470;4475;3533;0
SMOT;3527;100;3454;300;3451;3445;3527;0
FPAG;3452;1300;3055;1100;3049;3044;2552;900
ATMP;3426;500;2929;900;2925;2915;3426;0
GDEC;3411;1363;3385;400;3381;3373;3411;0
ZJAN;3398;400;2571;1800;2565;2568;3398;0
RSSB;3391;100;2329;203;2328;2328;3391;0
IETC;3352;500;8586;400;8575;8545;3352;0
OUSM;3284;100;4332;300;4327;4330;3284;0
JANJ;3211;1500;2461;1500;2457;2462;3211;0
GHTA;3199;880;2835;901;2823;2830;3199;0
NUMG;3168;200;4756;500;4747;4751;3168;0
TMFX;3112;2500;1975;2600;1973;1964;3112;0
IEO;3087;100;9290;100;9286;9286;3087;0
BUFZ;3076;5200;2400;5000;2395;2400;3076;0
FMAG;3040;1700;3142;100;3140;3140;3039;1
ICLO;2995;300;2566;904;2565;2566;2995;0
GARP;2963;200;5694;200;5686;5674;2963;0
KDEC;2938;400;2401;46;2395;2392;2938;0
IBHF;2714;713;2321;2600;2320;2320;2714;0
GSID;2701;100;5462;100;5446;5446;2701;0
MSFX;2688;400;2653;200;2651;2661;2688;0
FFLG;2658;900;2562;1100;2559;2551;2141;517
IBHH;2611;600;2346;1700;2343;2342;2611;0
GOOX;2590;400;3368;100;3364;3364;2590;0
POCT;2459;1205;3968;2700;3963;3958;2459;0
BUFQ;2436;400;3160;265;3150;3155;2436;0
ESML;2416;100;4216;19;4213;4213;2416;0
JPLD;2386;2100;5153;600;5149;5151;2386;0
IYLD;2364;506;1957;500;1956;1956;2364;0
SNOV;2318;500;2314;100;2309;2303;2318;0
AAPX;2313;500;3038;500;3034;3027;2313;0
UDEC;2305;25;3521;25;3517;3515;2305;0
SMDV;2297;700;6598;500;6591;6597;2297;0
DDWM;2295;500;3461;1000;3454;3456;2295;0
FLHY;2287;700;2392;800;2391;2392;2287;0
IBHJ;2276;3870;2614;792;2612;2614;2276;0
BTCI;2250;29;6020;100;6015;6020;2250;0
TAIL;2146;100;1113;600;1111;1113;2146;0
SMB;2124;1900;1711;1700;1710;1711;2124;0
KOCT;2110;400;3066;300;3056;3058;2110;0
OMFS;2085;500;3950;600;3942;3907;2085;0
XMPT;2071;500;2171;800;2168;2167;2071;0
XJH;2066;500;4196;500;4185;4193;1866;200
MEAR;2042;600;5001;700;5000;5000;2042;0
DDLS;1996;600;3450;400;3444;3446;1996;0
EDEN;1994;200;10593;100;10559;10572;1994;0
JANU;1962;400;2515;500;2508;2512;1962;0
GVI;1953;800;10400;1000;10399;10399;1953;0
XDEC;1778;13;3738;200;3730;3736;1778;0
IYJ;1753;400;13369;200;13360;13324;1753;0
JPIB;1742;500;4734;42;4725;4731;1742;0
RSST;1737;600;2453;100;2441;2458;1737;0
FYLD;1726;300;2536;177;2526;2526;1726;0
HEGD;1725;594;2256;600;2252;2255;1725;0
NULV;1716;500;3946;806;3945;3922;1716;0
FDRV;1709;100;1351;600;1350;1352;1709;0
VCRM;1699;200;7440;1101;7438;7440;1699;0
STOT;1687;100;4688;600;4683;4684;1687;0
IBMR;1686;1700;2501;200;2494;2500;1686;0
XSHQ;1676;200;4213;1300;4203;4211;1676;0
NUEM;1536;300;2900;300;2881;2901;1536;0
NFLU;1535;825;3639;2125;3631;3632;1535;0
VTEC;1506;500;9930;1;9928;9927;1506;0
DIVB;1497;500;4740;1200;4737;4739;1497;0
ACIO;1491;3700;4040;100;4037;4025;1491;0
GSST;1490;3181;5029;700;5028;5028;1490;0
JUCY;1445;1500;2285;1100;2280;2284;1445;0
BUFY;1437;1100;1893;1172;1888;1892;1437;0
FRNW;1420;26;1395;500;1392;1392;1420;0
DECM;1381;700;3082;100;3075;3080;1381;0
DAUG;1380;68;3982;405;3981;3981;1380;0
DJUN;1372;400;4351;800;4341;4337;1372;0
PNOV;1352;4397;3802;200;3794;3793;1352;0
PJUL;1350;1105;4132;700;4122;4127;1350;0
IMFL;1320;100;2380;300;2371;2363;1320;0
ESG;1297;500;13840;500;13823;13789;1297;0
FFSM;1281;1000;2722;1000;2719;2720;1281;0
GOOP;1281;3100;3047;3100;3039;3007;1281;0
KJAN;1279;400;3749;2900;3735;3748;1279;0
SHYD;1274;300;2253;44;2248;2250;1274;0
FDEV;1268;100;2748;100;2739;2728;1268;0
QETH;1255;700;3311;1000;3305;3311;1255;0
TRTY;1213;32;2522;900;2518;2522;1213;0
PRNT;1211;200;2109;100;2103;2101;1211;0
JEMA;1209;100;3749;300;3744;3749;779;430
IBMQ;1175;1100;2521;1100;2519;2522;1175;0
EATV;1165;1100;1634;1100;1628;1622;1165;0
TMFS;1154;1336;3643;100;3639;3637;1154;0
NJAN;1105;2500;4830;39;4818;4799;1105;0
DFEB;1104;500;4291;200;4282;4279;1104;0
KRUZ;1086;5000;3165;2562;3155;3150;1036;50
QJUN;1078;166;2826;3800;2817;2808;1078;0
TUSI;1073;200;2531;900;2530;2532;1073;0
SMMV;1069;200;4121;300;4116;4117;1069;0
SEIM;1061;100;3935;100;3931;3915;1061;0
VCEB;1057;700;6168;900;6163;6165;1057;0
XBJA;1039;100;2889;3600;2883;2884;1039;0
OBND;1036;800;2565;600;2564;2562;1036;0
VTEI;1023;600;9925;600;9923;9925;1023;0
BUFG;1019;1400;2459;408;2453;2448;1019;0
NFLP;1005;3000;3410;3000;3401;3377;1005;0
FCPI;991;1100;4425;1200;4422;4425;991;0
IZRL;983;300;2296;100;2287;2284;975;8
PAWZ;969;200;5457;100;5434;5400;969;0
SVAL;950;100;3194;500;3188;3185;950;0
JAJL;936;206;2731;106;2729;2730;936;0
GCLN;925;100;3501;200;3487;3488;925;0
PAPR;925;500;3688;4221;3681;3681;925;0
PSDM;920;600;5075;500;5073;5073;920;0
DRAG;907;900;2084;300;2077;2085;907;0
YETH;907;490;5189;1;5170;5189;907;0
GMOM;897;300;2894;300;2886;2891;897;0
DUSA;896;100;4264;100;4256;4250;896;0
GDE;888;700;3797;200;3761;3767;888;0
TBJL;850;100;1949;100;1935;1947;850;0
ZDEK;850;2300;2396;1500;2392;2395;850;0
ABOT;847;1300;3632;1300;3626;3626;747;100
QSPT;823;400;2786;200;2773;2780;823;0
NUDM;812;100;3030;200;3021;3024;812;0
RBUF;806;1977;2618;100;2613;2618;806;0
VFVA;804;900;11850;200;11836;11843;804;0
FLQL;795;1800;5909;1700;5901;5903;795;0
PJUN;790;900;3770;200;3760;3759;790;0
PAUG;784;5;3867;2900;3859;3859;784;0
PMAR;776;100;4028;337;4021;4026;776;0
CEFS;773;300;2165;1;2160;2160;773;0
FJAN;753;1817;4605;2200;4600;4601;753;0
QHY;741;500;4523;600;4519;4518;741;0
GEMD;729;500;3985;600;3983;3982;729;0
SMMD;725;300;6819;200;6805;6758;725;0
IVRA;719;600;1541;100;1536;1535;718;1
FAUG;710;515;4678;800;4671;4668;710;0
BDEC;708;400;4326;2500;4316;4307;708;0
PMAY;706;100;3599;3000;3594;3594;706;0
SHEH;706;200;4936;500;4930;4925;706;0
TYA;701;600;1210;700;1209;1209;701;0
GSUS;700;100;8136;400;8130;8128;700;0
SEPM;700;800;2994;1000;2984;2987;700;0
EWUS;698;58;3349;100;3342;3336;698;0
IGHG;676;600;7846;800;7808;7820;676;0
VXZ;672;7;5125;300;5114;5139;672;0
EMTL;671;100;4224;600;4221;4219;671;0
MAGA;669;3700;4746;2000;4737;4715;669;0
CNAV;667;1973;2710;1800;2705;2683;667;0
VFMF;660;700;13093;800;13074;13086;660;0
IEDI;657;200;5359;200;5351;5323;657;0
DUBS;656;500;3257;600;3250;3256;656;0
TMFE;639;2800;2654;2800;2651;2638;639;0
HCRB;638;500;3432;600;3430;3432;638;0
XJR;636;600;4106;500;4094;4060;636;0
FCTR;633;1100;3268;1000;3259;3258;633;0
HSRT;612;600;3903;800;3898;3902;612;0
FJUN;607;375;5169;10;5163;5164;607;0
PBDE;601;1000;2645;1000;2640;2642;600;1
QSIG;600;600;4805;600;4801;4799;600;0
XVV;591;600;4564;500;4556;4548;591;0
RSSY;544;600;1997;100;1986;1992;544;0
SECT;543;100;5543;100;5541;5520;543;0
BEMB;540;500;5161;499;5158;5158;540;0
VFQY;538;600;14168;600;14147;14100;538;0
FDEM;535;500;2546;112;2545;2545;535;0
MAXJ;534;500;2622;1000;2619;2618;534;0
SLVP;528;300;1230;100;1227;1220;528;0
BUFF;526;500;4511;300;4502;4499;526;0
FCLD;524;200;2775;600;2765;2750;524;0
VWID;521;1000;2684;1000;2676;2677;521;0
KWT;506;300;3288;200;3267;3267;506;0
SPIN;506;1100;3128;100;3118;3120;506;0
QUVU;502;600;2451;700;2445;2446;502;0
MBCC;501;900;3452;400;3448;3436;501;0
TJUL;500;500;2788;300;2783;2782;300;200
UPSD;500;600;2408;500;2402;2407;500;0
CLSE;495;100;2307;100;2304;2293;495;0
KAPR;491;400;3284;200;3274;3258;491;0
OUSA;482;100;5290;100;5288;5279;482;0
EALT;480;400;3242;700;3237;3242;480;0
DWLD;473;300;3611;300;3599;3592;473;0
BAUG;469;200;4383;121;4374;4378;215;254
VEGN;452;2100;5403;2100;5395;5402;452;0
OILK;448;900;4495;1900;4490;4486;448;0
BSEP;438;800;4316;700;4305;4309;15;423
LQDW;423;100;2625;700;2621;2621;423;0
DFNL;422;200;3821;100;3816;3825;422;0
BUFB;421;200;3249;300;3237;3242;421;0
HFGO;405;300;2411;300;2406;2409;405;0
EPRF;401;300;1833;300;1829;1830;401;0
XNOV;401;400;3424;3100;3411;3409;401;0
DJUL;400;3400;4223;2600;4208;4205;400;0
EVLU;400;400;2454;400;2445;2446;400;0
HELX;400;600;2989;400;2984;2970;400;0
KAUG;400;400;2522;200;2514;2509;400;0
QMAR;400;400;2999;600;2990;2992;400;0
SAPH;400;500;5150;900;5131;5145;400;0
WDNA;400;500;1489;500;1483;1484;400;0
HAUS;398;100;1809;8;1808;1805;398;0
VSDM;396;600;7489;500;7483;7488;396;0
SNAV;388;3800;3019;2313;3014;2999;388;0
NUDV;379;200;2762;100;2761;2762;379;0
TOKE;379;200;509;200;503;505;379;0
MOTI;375;56;2994;400;2978;2989;375;0
FPFD;374;700;2152;200;2148;2152;374;0
GDMN;365;198;3050;200;3041;3010;365;0
SEIV;359;100;3344;300;3340;3324;359;0
TMFG;351;500;2827;100;2823;2820;351;0
PSEP;336;1400;3927;700;3917;3919;336;0
ZVOL;335;100;1869;45;1863;1863;335;0
OGIG;333;100;4646;100;4640;4643;333;0
ABFL;327;325;6676;700;6665;6671;58;269
TSLP;325;4900;3001;4900;2990;2988;325;0
MARM;324;500;3102;2600;3083;3093;324;0
BLKC;321;300;2295;300;2286;2288;305;16
OSCV;317;700;3665;700;3661;3657;317;0
PBP;314;100;2369;200;2363;2368;314;0
TMAT;308;100;2101;100;2099;2142;308;0
RSBT;302;100;1709;500;1701;1701;302;0
AESR;300;1200;1753;100;1749;1742;300;0
DECU;300;500;2467;200;2459;2462;300;0
LJAN;300;200;2463;4000;2457;2458;300;0
MPRO;300;100;2856;400;2854;2850;300;0
LQDI;297;500;2554;600;2540;2537;297;0
GPOW;296;200;5437;200;5425;5411;296;0
TMFM;296;100;2583;2200;2580;2562;296;0
ISVL;292;250;3427;65;3420;3416;292;0
CAOS;290;1500;8760;500;8752;8759;290;0
FPRO;275;100;2191;500;2187;2167;275;0
DOGG;273;500;1908;20;1904;1899;273;0
BBIB;270;600;9601;500;9599;9599;270;0
FFOG;270;500;4075;100;4068;4060;170;100
HYXU;269;653;4669;600;4663;4651;269;0
SFEB;263;400;2159;300;2152;2150;263;0
GFEB;262;400;3751;1300;3742;3739;262;0
BUYW;258;700;1397;200;1396;1395;258;0
GAUG;253;5;3543;3100;3535;3538;253;0
BJUN;249;400;4176;200;4165;4169;249;0
DECZ;233;2700;3713;2703;3702;3710;233;0
HYGW;233;402;3190;103;3187;3188;233;0
URAN;229;300;2985;77;2973;2975;228;1
EFNL;227;100;3277;100;3266;3247;227;0
ENOR;227;300;2294;100;2287;2285;227;0
INTL;224;1200;2224;1000;2219;2216;224;0
NURE;221;400;3083;400;3077;3077;221;0
OEUR;216;25;2794;600;2790;2777;216;0
BLDG;213;500;2487;500;2480;2475;213;0
KHPI;208;5100;2537;4600;2526;2533;208;0
GAA;206;300;2855;300;2845;2824;206;0
AAPY;204;3800;2660;3800;2652;2651;203;1
ADFI;202;100;836;1400;834;835;202;0
EFAD;201;300;3689;200;3684;3674;148;53
PEX;200;500;2767;500;2756;2750;200;0
RMIF;200;1500;2525;900;2518;2524;200;0
UOCT;200;3200;3545;3000;3536;3537;200;0
WUGI;200;300;7355;300;7329;7331;200;0
YDEC;200;114;2270;200;2263;2261;200;0
BHYB;199;500;5362;600;5358;5360;199;0
MSSS;199;100;2775;100;2772;2752;199;0
TDV;197;5;7610;400;7600;7591;197;0
DHDG;196;400;3068;200;3061;3056;196;0
IBHK;191;509;2540;700;2537;2540;191;0
NSEP;191;500;2585;2300;2573;2569;191;0
SEIQ;191;100;3483;100;3480;3475;191;0
ESGG;188;100;16973;100;16947;16861;188;0
MFUT;177;800;1652;7;1647;1644;177;0
XJUN;174;2600;3881;2800;3871;3873;174;0
XUSP;174;527;4062;500;4049;4055;174;0
BJUL;173;1500;4482;700;4472;4478;173;0
OVT;164;6800;2197;5000;2191;2190;164;0
BBRE;160;200;9235;100;9224;9207;160;0
BUYZ;155;800;3729;800;3719;3709;155;0
BMAY;153;3000;4052;2800;4041;4040;153;0
FFLV;152;1000;2142;1000;2139;2129;152;0
FFEB;151;2962;4999;300;4993;4995;151;0
IDVZ;148;2100;2515;100;2500;2505;148;0
GJUN;145;900;3620;200;3611;3612;145;0
MARZ;143;3200;3155;3200;3145;3144;143;0
FOCT;141;400;4290;100;4280;4272;141;0
QTJA;139;100;2526;1100;2520;2521;139;0
USEP;136;400;3535;100;3529;3530;136;0
BRLN;135;1000;5263;199;5240;5240;135;0
GHYG;135;500;4411;600;4406;4406;135;0
GVAL;134;300;2096;300;2082;2085;133;1
ROIS;130;200;4787;1000;4768;4779;130;0
XEMD;130;500;4199;600;4195;4196;130;0
BUSA;127;89;3190;2700;3189;3192;127;0
ARKZ;126;100;3646;100;3643;3696;126;0
AFIF;125;4000;919;302;915;916;125;0
GLOV;125;100;4981;400;4959;4960;125;0
IBMS;125;700;2540;700;2535;2540;125;0
EVUS;120;300;2890;300;2888;2893;120;0
PTEU;120;105;2433;300;2423;2416;120;0
RVRB;117;100;3065;100;3064;3053;117;0
JCPI;116;327;4660;100;4657;4657;116;0
ITWO;115;1190;3972;300;3968;3945;115;0
JANZ;115;1;3447;2900;3436;3436;115;0
BAMV;113;1100;3041;800;3037;3024;113;0
BMAR;113;900;4641;200;4629;4617;113;0
BUFS;113;1100;2137;1000;2131;2136;113;0
FMAR;111;100;4343;200;4334;4337;111;0
RSBY;110;100;1751;100;1740;1739;110;0
OVS;107;4200;3489;4200;3483;3463;107;0
XJAN;106;400;3386;1000;3376;3373;106;0
QCON;105;604;4551;500;4545;4538;105;0
XFEB;105;400;3282;1500;3274;3274;105;0
ARKA;103;100;6165;100;6158;6162;103;0
TJAN;103;3900;2548;100;2545;2546;103;0
BBLB;102;500;8139;500;8136;8123;102;0
FSEP;102;400;4593;100;4585;4586;102;0
ADME;101;100;4706;100;4699;4684;101;0
DURA;101;200;3245;400;3242;3225;101;0
GJUL;101;2372;3683;1700;3674;3669;101;0
PSMR;101;3700;2812;7;2802;2798;101;0
SMAX;101;101;2528;205;2526;2525;101;0
APRQ;100;4100;2470;4100;2457;2467;100;0
AQLT;100;200;2438;200;2431;2425;100;0
ARKC;100;100;3894;100;3851;3883;100;0
AZNH;100;700;4304;500;4296;4308;100;0
BAMO;100;1000;3044;800;3041;3033;100;0
DSEP;100;2900;4075;2700;4065;4070;100;0
FAPR;100;400;4147;300;4136;4137;100;0
FDTB;100;1200;939;800;936;936;100;0
JUNM;100;500;3187;200;3177;3184;100;0
MVFG;100;200;2595;700;2593;2592;100;0
MYLD;100;300;2560;1200;2555;2556;100;0
NDEC;100;400;2456;2300;2444;2446;100;0
OVB;100;7400;2013;5000;2008;2005;100;0
PSCJ;100;300;2685;300;2678;2677;100;0
RPHS;100;1000;1020;900;1011;1012;100;0
UAPR;100;595;3101;400;3094;3093;100;0
XSEP;100;300;3907;200;3895;3898;100;0
YSEP;100;400;2188;3000;2174;2181;100;0
WEED;97;300;1591;1;1583;1583;97;0
XBJL;97;3100;3431;3210;3419;3434;97;0
TILT;94;400;21718;400;21697;20541;94;0
RDFI;91;3;2353;3000;2352;2355;91;0
YJUN;91;200;2173;3000;2163;2175;91;0
DINT;89;200;2158;100;2154;2154;89;0
TDVI;87;500;2442;500;2437;2435;87;0
TGLR;86;1600;2995;16;2989;2989;86;0
SAUG;84;400;2366;300;2358;2364;84;0
FJUL;82;71;4919;205;4912;4909;82;0
FMAY;82;500;4766;200;4758;4755;82;0
ARKD;76;500;4822;300;4810;4827;76;0
QLC;71;500;6695;500;6685;6668;71;0
LKOR;68;500;4142;600;4139;4123;68;0
EAOR;65;300;3141;300;3137;3130;65;0
MSTB;65;2500;3412;100;3394;3374;65;0
IGLD;63;100;1902;100;1889;1896;63;0
BKGI;62;1100;3048;1100;3042;3030;62;0
PSFD;61;3100;3333;3100;3316;3371;61;0
BAMU;56;1600;2519;1000;2515;2541;56;0
BAPR;55;900;4461;400;4450;4450;55;0
FIBR;55;700;8713;700;8704;8701;55;0
XDSQ;54;100;3676;3100;3660;3655;54;0
ZAUG;54;1280;2495;2600;2481;2490;54;0
ZSEP;54;500;2515;1500;2511;2509;54;0
FDHT;52;600;2013;500;2005;2000;52;0
IWMW;52;400;4431;200;4419;4400;52;0
YMAR;52;200;2296;3000;2281;2283;52;0
BGLD;51;200;1866;100;1854;1853;51;0
GJAN;50;805;3879;2600;3855;3878;50;0
BCHP;48;1500;3433;1500;3428;3400;48;0
LOCT;48;1571;2383;1500;2379;2380;48;0
EGUS;45;300;4501;300;4498;4495;45;0
GHMS;41;500;2537;600;2532;2532;41;0
NAPR;41;400;5070;300;5054;5058;41;0
ARKY;37;100;3741;100;3678;3747;37;0
NOCT;37;400;5164;300;5148;5143;37;0
BNOV;34;48;3946;500;3938;3930;34;0
GSEP;34;1900;3522;1500;3515;3514;34;0
APRZ;33;2900;3444;2900;3432;3387;33;0
IQM;33;600;6829;600;6810;6799;33;0
GMAY;32;400;3710;2600;3687;3698;32;0
PSMO;32;400;2773;400;2767;2752;32;0
NJUL;31;400;6317;200;6297;6302;31;0
CORX;30;100;1689;100;1680;1688;30;0
EUDV;30;100;4667;200;4648;4629;30;0
HOCT;30;1500;2385;1700;2381;2384;30;0
SNPG;30;25;4581;25;4577;4576;30;0
FHEQ;29;1000;2766;100;2763;2756;29;0
PBTP;29;500;2544;700;2543;2543;29;0
AMZP;28;3100;3247;3100;3240;3246;26;2
ZJUL;28;500;2716;200;2707;2718;28;0
PBFR;27;500;2655;500;2649;2652;27;0
FAIL;26;100;1620;100;1597;1604;26;0
XDQQ;25;3300;3508;3300;3494;3506;25;0
OVL;22;3100;4690;3200;4682;4686;22;0
FDVL;21;100;1028;100;1027;1030;21;0
XTJA;21;200;2789;200;2780;2778;21;0
AAPR;20;1200;2647;1000;2640;2638;20;0
EAOA;20;400;3590;400;3585;3572;20;0
HSUN;20;600;3433;600;3429;3430;20;0
IVVB;20;500;3071;501;3065;3068;20;0
BBSB;19;1100;9795;1000;9787;9788;19;0
PSH;19;500;5024;500;5014;5012;19;0
XBOC;19;6;3037;3400;3029;3025;19;0
PIT;18;300;4790;300;4778;4818;18;0
GUNZ;17;500;2711;183;2702;2676;17;0
DNOV;16;900;4309;500;4299;4298;16;0
BFEB;15;500;4321;2600;4314;4309;15;0
BOCT;15;2700;4345;2500;4334;4341;15;0
IVVW;15;800;4927;200;4915;4924;15;0
FBUF;14;1000;2750;1000;2746;2759;14;0
XJUL;14;800;3564;235;3553;3566;14;0
BJAN;13;2600;4814;500;4804;4799;13;0
BAMA;11;100;3071;100;3069;3077;11;0
GOLY;11;11;2437;900;2420;2440;11;0
MINN;10;200;2208;900;2189;2206;10;0
NNOV;10;2500;2600;430;2588;2597;10;0
PSMD;10;3500;2933;3500;2920;2929;10;0
QPFF;10;200;3624;200;3601;3609;10;0
TLTP;10;400;2326;307;2317;2312;10;0
LFAE;9;100;1192;1700;1191;1190;9;0
VAMO;9;300;2983;1700;2974;2962;9;0
GTIP;8;500;4815;1000;4813;4812;8;0
MOTG;8;1000;3632;1000;3626;3620;8;0
XISE;6;200;3022;90;3013;3023;6;0
CMCI;5;100;2474;100;2428;2320;5;0
HEEM;5;600;2701;1100;2695;2696;5;0
LBO;5;500;3297;500;3289;3285;5;0
WBAT;5;1000;2706;500;2697;2718;5;0
XAUG;5;400;3433;200;3423;3436;5;0
CSM;4;2200;6672;1700;6661;6663;4;0
ESGX;4;500;2476;197;2471;2445;4;0
MFUL;4;900;2152;900;2148;2148;4;0
XIDE;4;200;3020;2500;3000;3011;4;0
XIJN;4;1500;3074;1500;3068;3068;4;0
EAOK;3;300;2549;300;2546;2545;3;0
NXTI;3;1000;2831;1100;2825;2825;3;0
AJAN;2;800;2632;200;2625;2634;2;0
ETQ;2;1200;964;1200;963;948;1;1
GDMA;2;800;3178;5500;3174;3210;2;0
JANP;2;1000;2899;1000;2894;2899;2;0
MBBB;2;600;2108;500;2107;2102;2;0
PUTD;2;1000;2082;100;2072;2081;2;0
SPMV;2;500;4586;500;4578;4590;2;0
UJUL;2;1200;3468;500;3460;3462;2;0
ACSI;1;2800;6100;2800;6092;6076;1;0
BINV;1;100;2989;1000;2982;2983;1;0
BPH;1;900;5088;900;5074;5125;1;0
BWTG;1;100;3422;100;3414;3357;1;0
DAPR;1;400;3735;200;3725;3729;1;0
DWCR;1;100;2815;100;2778;2860;1;0
EMDV;1;200;4266;200;4245;4236;1;0
FDCE;1;1300;1278;1200;1272;1274;1;0
FLQS;1;200;4151;400;4146;4152;1;0
GMAR;1;2500;3761;200;3753;3757;1;0
IPDP;1;7400;1939;7300;1929;2028;1;0
IPPP;1;11600;1011;11600;998;1001;1;0
ISDB;1;500;2490;600;2488;2489;1;0
IVVM;1;500;3083;500;3076;3081;1;0
LCF;1;900;3658;900;3654;3654;1;0
LEAD;1;400;6697;400;6686;6667;1;0
LJUL;1;3900;2393;200;2387;2400;1;0
PFEB;1;1000;3697;3000;3687;3693;1;0
TFJL;1;100;1976;200;1971;1969;1;0
XIMR;1;200;3105;700;3096;3092;1;0
ABHY;0;7000;1904;7100;1897;0;0;0
ABLD;0;100;2835;5000;2827;0;0;0
ABLG;0;5000;2902;100;2888;0;0;0
AJUL;0;3100;2708;3000;2700;0;0;0
AOCT;0;4000;2498;4000;2483;0;0;0
APOC;0;800;2555;4;2539;0;0;0
APRD;0;4000;2477;4000;2466;0;0;0
APRH;0;4100;2474;4102;2462;0;0;0
APRJ;0;4100;2471;4100;2460;0;0;0
APRP;0;1000;2771;1000;2766;0;0;0
ARCM;0;1000;10034;1000;10022;0;0;0
ARLU;0;500;2743;200;2737;0;0;0
AUGM;0;500;3196;200;3188;0;0;0
AUGP;0;1000;2724;1000;2718;0;0;0
AUGU;0;400;2636;200;2629;0;0;0
AUGZ;0;2600;3888;2600;3879;0;0;0
BAMB;0;100;2550;100;2549;0;0;0
BAMD;0;1000;3123;800;3121;0;0;0
BAMG;0;100;3451;100;3449;0;0;0
BAMY;0;100;2660;100;2658;0;0;0
BOXA;0;2500;9970;50;9940;0;0;0
BSMC;0;1000;3041;1400;3031;0;0;0
BUFP;0;500;2683;500;2677;0;0;0
BUFT;0;500;2252;200;2246;0;0;0
COPA;0;300;2298;300;2288;0;0;0
CPSL;0;1500;2562;800;2556;0;0;0
CVAR;0;1700;2500;1700;2486;0;0;0
DECP;0;1000;2664;1000;2658;0;0;0
DFND;0;200;4357;1;4001;0;0;0
DJAN;0;1000;3921;200;3910;0;0;0
DMAR;0;100;3829;1901;3826;0;0;0
DMAY;0;2900;4096;2700;4085;0;0;0
DOCT;0;400;3952;2500;3928;0;0;0
DSCF;0;500;2226;500;2222;0;0;0
DWAT;0;1000;1164;1000;1160;0;0;0
EAOM;0;300;2741;300;2738;0;0;0
EQLT;0;400;2361;1000;2352;0;0;0
EUAD;0;900;2490;100;2475;0;0;0
FDGR;0;1000;1396;800;1394;0;0;0
FDND;0;500;2262;600;2254;0;0;0
FEBP;0;1000;2852;1000;2846;0;0;0
FEBZ;0;2900;3461;2900;3452;0;0;0
FFDI;0;400;2480;400;2473;0;0;0
FFEM;0;1400;2426;600;2418;0;0;0
FFGX;0;900;2452;1300;2445;0;0;0
FHDG;0;400;3084;1200;3074;0;0;0
FLDZ;0;100;2774;6300;2768;0;0;0
FNOV;0;400;4809;900;4796;0;0;0
FOWF;0;1000;2420;100;2416;0;0;0
FPAS;0;800;2474;700;2471;0;0;0
FUNL;0;700;4198;700;4190;0;0;0
FYEE;0;1000;2696;1000;2693;0;0;0
GAPR;0;400;3762;800;3751;0;0;0
GBXA;0;400;2503;200;2496;0;0;0
GLBL;0;1700;2139;600;2129;0;0;0
GNOV;0;400;3509;12;3499;0;0;0
GOCT;0;4000;3517;3200;3509;0;0;0
GSKH;0;900;5043;900;5029;0;0;0
HAPR;0;1500;2514;1500;2508;0;0;0
HEAT;0;1000;2574;1000;2565;0;0;0
HIYS;0;500;2553;600;2549;0;0;0
HJUL;0;2000;2397;2000;2389;0;0;0
HSBH;0;200;5663;500;5660;0;0;0
HYKE;0;100;2721;600;2715;0;0;0
IDUB;0;200;2012;100;2006;0;0;0
IMSI;0;600;5113;500;5098;0;0;0
IPAV;0;300;2297;300;2288;0;0;0
JANH;0;1500;2462;1500;2458;0;0;0
JNEU;0;400;2742;200;2734;0;0;0
JULD;0;1500;2502;1700;2497;0;0;0
JULH;0;1500;2497;1700;2492;0;0;0
JULJ;0;1500;2496;1500;2491;0;0;0
JULM;0;1700;3155;1500;3147;0;0;0
JULP;0;1000;2724;1000;2719;0;0;0
JULQ;0;1500;2492;1500;2488;0;0;0
JULU;0;400;2665;200;2658;0;0;0
JULZ;0;2400;4186;2400;4176;0;0;0
JUNP;0;1000;2722;1000;2717;0;0;0
JUNZ;0;3300;2984;3300;2974;0;0;0
KJUL;0;50;2948;300;2943;0;0;0
KJUN;0;1900;2700;1700;2693;0;0;0
KNOV;0;400;2553;1500;2544;0;0;0
KNOW;0;200;1080;200;1069;0;0;0
KSEP;0;400;2580;1500;2570;0;0;0
LAPR;0;1500;2512;1500;2506;0;0;0
LDDR;0;5000;824;10000;820;0;0;0
LDER;0;5000;1110;10000;1104;0;0;0
LDRR;0;100;1331;100;1326;0;0;0
LFAF;0;100;1242;1600;1240;0;0;0
LFAI;0;1600;1292;1600;1290;0;0;0
LFAJ;0;1600;1337;1600;1334;0;0;0
LFAK;0;6500;1382;1500;1379;0;0;0
LFAL;0;1600;1423;1600;1421;0;0;0
LFAN;0;100;1460;1600;1458;0;0;0
LFAO;0;1500;1499;1500;1496;0;0;0
LFAQ;0;6500;1536;1500;1532;0;0;0
LFAR;0;1500;1571;1500;1568;0;0;0
LFAU;0;5000;1603;1500;1599;0;0;0
LFAV;0;6500;1633;1500;1629;0;0;0
LFAW;0;1500;1667;1500;1664;0;0;0
LFAX;0;1500;1700;1500;1696;0;0;0
LFAZ;0;6500;1728;1500;1724;0;0;0
LFBB;0;6500;1756;1500;1752;0;0;0
LFBD;0;100;1799;100;1794;0;0;0
LFBE;0;100;1826;100;1820;0;0;0
LFDR;0;1500;1825;1500;1819;0;0;0
LIAB;0;1500;1529;1500;1525;0;0;0
LIAC;0;1500;1608;1500;1604;0;0;0
LIAE;0;1500;1685;1500;1681;0;0;0
LIAF;0;1500;1760;1500;1756;0;0;0
LIAG;0;1500;1835;1500;1831;0;0;0
LIAJ;0;1500;1908;1500;1904;0;0;0
LIAK;0;1500;1977;1500;1973;0;0;0
LIAM;0;1500;2050;1500;2045;0;0;0
LIAO;0;1500;2119;1500;2114;0;0;0
LIAP;0;1500;2185;1500;2180;0;0;0
LIAQ;0;1500;2252;1500;2247;0;0;0
LIAT;0;1500;2314;1500;2309;0;0;0
LIAU;0;1500;2382;1500;2377;0;0;0
LIAV;0;1500;2447;5000;2439;0;0;0
LIAW;0;1500;2512;1500;2507;0;0;0
LIAX;0;1500;2576;1500;2570;0;0;0
LIAY;0;5000;2518;5000;2506;0;0;0
LIBD;0;5000;2575;5000;2563;0;0;0
LIMI;0;100;2490;300;2476;0;0;0
LYLD;0;100;2545;100;2542;0;0;0
MAMB;0;800;2210;800;2208;0;0;0
MAYP;0;1000;2796;1000;2791;0;0;0
MAYU;0;400;2862;200;2855;0;0;0
MAYZ;0;3400;3029;3400;3017;0;0;0
MBND;0;700;2751;100;2741;0;0;0
MBNE;0;200;2946;700;2934;0;0;0
MDEV;0;1100;2101;1000;2094;0;0;0
MDLV;0;900;2571;1700;2563;0;0;0
MDPL;0;500;2518;500;2513;0;0;0
MGRO;0;500;3069;500;3068;0;0;0
MIG;0;600;2100;500;2096;0;0;0
MILK;0;300;2435;300;2432;0;0;0
MOTE;0;600;2805;600;2800;0;0;0
MRCP;0;1000;2819;1000;2814;0;0;0
MRGR;0;500;4148;500;4131;0;0;0
MSFY;0;3400;2548;3400;2537;0;0;0
MSTQ;0;2500;3297;2500;3278;0;0;0
MVAL;0;500;3208;500;3204;0;0;0
MVFD;0;100;2570;100;2565;0;0;0
NAUG;0;77;2587;1500;2585;0;0;0
NDOW;0;900;2444;900;2432;0;0;0
NJUN;0;3800;2740;4000;2732;0;0;0
NOVM;0;500;3068;2500;3049;0;0;0
NOVP;0;1000;2727;1000;2722;0;0;0
NOVZ;0;2500;4044;2500;4029;0;0;0
NULC;0;700;4595;600;4591;0;0;0
NVBU;0;500;2573;200;2564;0;0;0
NVOH;0;900;5068;900;5056;0;0;0
NXTV;0;100;2542;1100;2531;0;0;0
OCTD;0;4100;2395;4100;2383;0;0;0
OCTH;0;4100;2396;100;2389;0;0;0
OCTJ;0;4200;2395;4200;2383;0;0;0
OCTM;0;800;3064;1000;3054;0;0;0
OCTP;0;1000;2694;1000;2688;0;0;0
OCTQ;0;200;2390;4200;2380;0;0;0
OCTU;0;500;2549;200;2540;0;0;0
OCTZ;0;2600;3944;2600;3928;0;0;0
OVF;0;6300;2362;5000;2357;0;0;0
OVLH;0;4300;3428;4300;3424;0;0;0
PBAP;0;1000;2737;1000;2730;0;0;0
PBAU;0;1000;2694;1000;2688;0;0;0
PBFB;0;1000;2780;1000;2773;0;0;0
PBJA;0;1000;2808;1100;2802;0;0;0
PBJL;0;1000;2691;1000;2685;0;0;0
PBJN;0;1000;2688;1000;2682;0;0;0
PBL;0;2000;2831;500;2818;0;0;0
PBMR;0;1000;2766;1000;2760;0;0;0
PBMY;0;1000;2748;1000;2742;0;0;0
PBNV;0;1000;2692;1000;2686;0;0;0
PBOC;0;1000;2659;1000;2653;0;0;0
PBSE;0;1000;2672;1000;2665;0;0;0
PIEQ;0;300;2454;100;2444;0;0;0
PJBF;0;700;6116;700;6103;0;0;0
PJFM;0;500;5862;500;5848;0;0;0
PMJA;0;3600;2510;3600;2501;0;0;0
PSCQ;0;400;2660;400;2654;0;0;0
PSCW;0;4000;2643;4000;2627;0;0;0
PSCX;0;3700;2790;3700;2775;0;0;0
PSFJ;0;300;2940;300;2933;0;0;0
PSFM;0;3500;2993;3500;2979;0;0;0
PSFO;0;500;2890;500;2883;0;0;0
PSMJ;0;200;2859;300;2853;0;0;0
PWS;0;500;3054;500;3051;0;0;0
QBER;0;2400;2477;2400;2463;0;0;0
QBUL;0;2400;2484;2400;2469;0;0;0
QCAP;0;100;2222;200;2216;0;0;0
QCJL;0;200;2108;100;2099;0;0;0
QCOC;0;42;2024;1036;2020;0;0;0
QIG;0;500;4362;600;4359;0;0;0
QMAG;0;1200;2101;1000;2094;0;0;0
QMMY;0;300;2174;400;2171;0;0;0
QMNV;0;1200;2032;1000;2025;0;0;0
QTAP;0;400;3773;2500;3748;0;0;0
QTJL;0;400;3274;200;3262;0;0;0
QTOC;0;200;2948;200;2938;0;0;0
QVOY;0;1700;2549;900;2545;0;0;0
RODE;0;200;2756;200;2745;0;0;0
ROMO;0;900;3178;1700;3167;0;0;0
RSBA;0;500;1993;500;1990;0;0;0
RSEE;0;3900;2874;3000;2868;0;0;0
RTAI;0;100;2133;100;2131;0;0;0
RTRE;0;300;2456;300;2447;0;0;0
RULE;0;900;2222;900;2211;0;0;0
RYSE;0;600;2507;500;2503;0;0;0
SCLZ;0;900;5318;900;5307;0;0;0
SELV;0;1400;2907;1300;2902;0;0;0
SEPP;0;1000;2696;1000;2691;0;0;0
SEPU;0;500;2594;200;2586;0;0;0
SEPZ;0;100;3839;2600;3829;0;0;0
SHAG;0;100;4719;600;4716;0;0;0
SHDG;0;100;2937;100;2927;0;0;0
SMAY;0;400;2493;300;2483;0;0;0
SMI;0;500;4581;500;4578;0;0;0
SNPD;0;700;2569;700;2567;0;0;0
SNPV;0;700;3157;700;3154;0;0;0
SPCZ;0;900;2609;900;2578;0;0;0
SQMX;0;200;3086;200;3075;0;0;0
STBF;0;5600;2508;2200;2506;0;0;0
TDEC;0;400;1983;200;1977;0;0;0
TLTI;0;500;4618;600;4615;0;0;0
TMDV;0;500;4608;500;4601;0;0;0
TRSY;0;1000;3006;1100;3004;0;0;0
TSEP;0;200;1967;200;1958;0;0;0
TYLD;0;600;2528;600;2525;0;0;0
UAUG;0;3300;3570;200;3561;0;0;0
UFEB;0;100;3337;3300;3329;0;0;0
UJAN;0;400;3908;100;3899;0;0;0
UJUN;0;45;3396;500;3387;0;0;0
UMAR;0;400;3587;1000;3575;0;0;0
UMAY;0;400;3377;3200;3366;0;0;0
UNOV;0;100;3478;300;3470;0;0;0
UXOC;0;700;3061;700;3051;0;0;0
VMAX;0;100;4844;100;4838;0;0;0
WHTX;0;100;1437;100;1428;0;0;0
WLDR;0;300;2999;100;2961;0;0;0
XAPR;0;100;3243;1500;3238;0;0;0
XBAP;0;100;3423;1832;3414;0;0;0
XDAP;0;3100;3567;100;3556;0;0;0
XDAT;0;300;2560;500;2552;0;0;0
XDJL;0;3100;3494;3100;3485;0;0;0
XDOC;0;3400;3053;3400;3042;0;0;0
XMAR;0;3200;3633;1264;3623;0;0;0
XMAY;0;400;3168;2500;3149;0;0;0
XOCT;0;100;3433;100;3429;0;0;0
XTAP;0;300;3476;2500;3454;0;0;0
XTJL;0;200;3386;200;3375;0;0;0
XTOC;0;300;2958;300;2948;0;0;0
XVOL;0;900;2151;900;2134;0;0;0
ZNOV;0;400;2519;2600;2502;0;0;0
ZOCT;0;800;2534;1500;2530;0;0;0
